int map[][] = {
        {9, 9, 9, 9, 9, 9, 9, 9, 9, 9, 9, 9, 9, 9, 9, 9, 9, 9, 9, 9, 9},
        {9, 0, 0, 2, 0, 0, 0, 0, 0, 2, 0, 0, 2, 0, 0, 0, 0, 0, 0, 0, 9},
        {9, 0, 1, 0, 1, 2, 1, 0, 1, 0, 1, 2, 1, 2, 1, 2, 1, 2, 1, 0, 9},
        {9, 2, 0, 2, 0, 0, 0, 2, 0, 2, 2, 2, 2, 0, 0, 0, 2, 0, 2, 0, 9},
        {9, 0, 1, 0, 1, 0, 1, 2, 1, 0, 1, 0, 1, 0, 1, 0, 1, 2, 1, 0, 9},
        {9, 0, 2, 0, 2, 0, 0, 0, 2, 0, 0, 0, 0, 2, 2, 2, 2, 0, 0, 2, 9},
        {9, 0, 1, 0, 1, 0, 1, 0, 1, 0, 1, 0, 1, 2, 1, 0, 1, 0, 1, 0, 9},
        {9, 2, 0, 2, 0, 2, 0, 0, 0, 2, 2, 2, 2, 0, 2, 0, 2, 0, 2, 0, 9},
        {9, 0, 1, 0, 1, 0, 1, 2, 1, 0, 1, 2, 1, 0, 1, 2, 1, 2, 1, 0, 9},
        {9, 2, 2, 0, 0, 0, 0, 0, 2, 0, 0, 0, 2, 0, 0, 0, 0, 0, 0, 0, 9},
        {9, 0, 1, 2, 1, 0, 1, 0, 1, 0, 1, 2, 1, 0, 1, 0, 1, 0, 1, 0, 9},
        {9, 2, 2, 0, 0, 2, 0, 0, 2, 0, 2, 0, 0, 0, 2, 2, 0, 2, 0, 0, 9},
        {9, 9, 9, 9, 9, 9, 9, 9, 9, 9, 9, 9, 9, 9, 9, 9, 9, 9, 9, 9, 9}
       };


int map[][] = {
{1, 1, 1, 1, 1, 1, 1, 1, 1, 1, 1, 1, 1, 1, 1, 1, 1, 1, 1, 1, 1, 1, 1, 1, 1, 1, 1, 1, 1, 1, 1},
{1, 0, 0, 0, 0, 0, 0, 0, 2, 0, 2, 0, 0, 0, 0, 2, 0, 0, 0, 2, 0, 0, 2, 0, 2, 0, 2, 0, 0, 0, 1},
{1, 0, 1, 0, 1, 0, 1, 2, 1, 0, 1, 0, 1, 2, 1, 2, 1, 0, 1, 0, 1, 0, 1, 2, 1, 2, 1, 2, 1, 0, 1},
{1, 0, 0, 6, 2, 0, 0, 0, 0, 0, 5, 2, 2, 0, 0, 2, 0, 0, 0, 0, 0, 0, 2, 0, 0, 0, 2, 0, 2, 0, 1},
{1, 0, 1, 0, 1, 0, 1, 0, 1, 0, 1, 2, 1, 0, 1, 0, 1, 2, 1, 2, 1, 0, 1, 0, 1, 0, 1, 0, 1, 2, 1},
{1, 7, 0, 0, 0, 0, 0, 0, 0, 0, 0, 6, 0, 2, 2, 0, 0, 2, 0, 0, 2, 0, 0, 0, 0, 0, 0, 0, 0, 0, 1},
{1, 0, 1, 0, 1, 0, 1, 0, 1, 0, 1, 0, 1, 0, 1, 0, 1, 0, 1, 2, 1, 0, 1, 2, 1, 0, 1, 0, 1, 0, 1},
{1, 2, 0, 0, 2, 0, 0, 0, 0, 0, 0, 2, 0, 0, 2, 0, 0, 0, 0, 0, 0, 2, 0, 0, 0, 0, 0, 0, 0, 0, 1},
{1, 0, 1, 0, 1, 0, 1, 0, 1, 2, 1, 0, 1, 0, 1, 0, 1, 2, 1, 2, 1, 0, 1, 0, 1, 0, 1, 0, 1, 0, 1},
{1, 2, 0, 0, 0, 0, 2, 2, 0, 0, 2, 0, 0, 0, 0, 0, 0, 0, 2, 0, 0, 0, 0, 0, 0, 0, 0, 0, 0, 0, 1},
{1, 0, 1, 2, 1, 0, 1, 0, 1, 0, 1, 0, 1, 0, 1, 0, 1, 2, 1, 0, 1, 0, 1, 0, 1, 0, 1, 0, 1, 0, 1},
{1, 0, 0, 0, 0, 0, 0, 0, 0, 0, 0, 0, 2, 0, 0, 0, 2, 0, 0, 2, 0, 0, 0, 0, 0, 0, 0, 0, 0, 0, 1},
{1, 1, 1, 1, 1, 1, 1, 1, 1, 1, 1, 1, 1, 1, 1, 1, 1, 1, 1, 1, 1, 1, 1, 1, 1, 1, 1, 1, 1, 1, 1}
}

// 1 la wall
      // 2 la box
      // 0 la grass
      // 5 la item bom
      // 6 la portal
      // 7 la flame item